1 1 1 1 1 1 1 1 1 1 1 1 1 1 1 1
1 0 0 0 0 0 0 0 0 1 1 1 0 0 1 1
1 2 1 1 1 1 1 1 0 1 2 0 0 0 0 1
1 0 1 1 1 1 1 1 0 1 1 0 0 50 0 1
1 1 1 1 5 1 1 1 0 1 1 1 0 0 0 1
1 1 1 1 12 1 1 1 0 1 1 1 0 0 1 1
1 1 1 1 0 1 1 1 2 1 1 0 0 1 1 1
1 1 1 1 0 1 1 1 0 0 0 2 1 1 1 1
1 1 1 1 0 1 1 1 0 0 1 0 0 0 1 1
1 0 1 1 0 1 1 1 0 1 1 1 1 0 1 1
1 0 10 0 0 0 0 0 0 1 1 1 0 0 0 1
1 0 0 0 1 1 1 0 0 1 1 1 0 0 0 1
1 0 1 1 1 1 1 0 0 1 1 1 0 1 0 1
1 2 1 1 1 0 0 0 0 5 13 0 0 1 2 1
1 1 1 1 0 0 0 0 0 0 0 0 2 1 0 1
1 1 1 1 1 0 1 1 1 1 1 11 1 1 0 1
1 1 1 1 1 0 1 1 1 1 0 0 1 1 0 1
1 2 1 1 1 0 1 1 1 1 0 0 1 1 0 1
1 0 1 0 0 0 1 1 1 1 0 0 0 0 0 1
1 0 0 0 0 0 0 0 0 0 0 0 0 0 1 1
1 1 1 1 1 1 1 1 1 1 1 1 0 1 1 1
1 1 1 1 1 1 1 1 1 1 1 1 -1 1 1 1